Meži	ir apkārt	LATVIJA
Brīvība	piedēr tikai	Iedzivotāji
piemenekļi	ir vēcas un daudz	LATVIJA
Plaši lauku	ar augošiem	Ziedošas pļavas
kulturās objektiem	veidoti no	Baznīcas
"Straume"	saņēma	Oskars premija
Svaigi cepta	var būt	Rudzu maize
viļņi	ir daļa no	Jūra
fani	vieno	LATVIJA
varonis	piedēr	LATVIJA
Iedzivotāji	Neatņēmāma sastavdāļa no	LATVIJA
Porziņģis	spēlē un ir labākais	Basketbols
Ziedošas pļavas	ir apkārt	LATVIJA
dzejoļi	piedēr	LATVIJA
Tautastērpi	piedēr	LATVIJA
ēdiens	piedēr	LATVIJA
fani	dzīvo	LATVIJA
Oskars premija	ir atvests uz	LATVIJA
Baltijā	ir izveidota no	LATVIJA
piemenekļi	veidoti no	Baznīcas
Ziedošas pļavas	blākus	Meži
3.vieta PČ	ir iegūta	hokejs
spēcīgiem vārdiem	var atrasties	dzejoļi
Rīga	ir mūsu	galvaspilsēta
Rudzu maize	daļa no	ēdiens
kvēloši ugunskuri	piedēr	LATVIJA
Dzintars	atrodas	Jūrmalas pludmales
upes	ir nozīmigs	dabas objekti
Lauksaimniecība	dod daudz eksportu	LATVIJA
dabas objekti	ir sirds	LATVIJA
Jāņi	ir nacionālie svētki	LATVIJA
Latvijas dievi	atrodas	Mitoloģija
Jūra	ir nozīmigs	dabas objekti
zaļi	ir vairāk	Meži
dzidri	ir	ezeri
Daugava	ir galvēnas	upes
galvaspilsēta	kas atrodās	LATVIJA
Mitoloģija	piedēr	LATVIJA
Pasakas	piedēr	LATVIJA
Tevzeme	piedēr tikai	Iedzivotāji
Jūrmalas pludmales	ir daļa no	Jūra
Basketbols	daļa no nacionāla	Sporta veidi
ezeri	ir nozīmigs	dabas objekti
Sporta veidi	vieno	LATVIJA
Siera nosaukums	ir	Dzintars
Gauja	ir galvēnas	upes
Lāčplesis	ir mūsu	varonis
Ligo	ir nacionālie svētki	LATVIJA
lepni	ir vairāki	Iedzivotāji
Baznīcas	ir vēcas un daudz	LATVIJA
hokejs	daļa no nacionāla	Sporta veidi
